 |||| |||| 
-o||o-o||o-
--oo---oo--
--oo---oo--
-o||o-o||o-
 |||| |||| 